Andean Guan - アンデスシャクケイ
Andean Tinamou - アンデスシギダチョウ
Australian Brushturkey - オーストラリアノスリョウ
Band-tailed Guan - オグロカンムリケン
Bartletts Tinamou - バートレットティナム
Bearded Guan - ヒゲカンムリケン
Black-capped Tinamou - クロガシラティナム
Blue-throated Piping Guan - アオノドホイッスルケン
Brazilian Tinamou - ブラジリアンティナム
Brushland Tinamou - ヤブチナム
Cauca Guan - コウカカンムリケン
Chaco Chachalaca - チャコカシャラカ
Chestnut-winged Chachalaca - チャバネヒメシャクケイ
Cinereous Tinamou - ハイイロティナム
Colombian Chachalaca - コロンビアカシャラカ
Crested Guan - カンムリカシャラカ
Dusky Megapode - クロボシセイケイ
Dusky-legged Guan - クロアシシャクケイ
Dwarf Tinamou - コガタチナム
Great Tinamou - オオチナム
Grey Tinamou - ハイイロチナム
Grey-headed Chachalaca - ハイガシラカシャラカ
Highland Tinamou - タカチナム
Little Tinamou - コチナム
Orange-footed Scrubfowl - オレンジアシヤブセイケイ
Pale-browed Tinamou - ウスマユチナム
Plain Chachalaca - ムジヒメシャクケイ
Red-legged Tinamou - アカアシチナム
Red-winged Tinamou - アカハネチナム
Rufous-bellied Chachalaca - アカハラカシャラカ
Rufous-headed Chachalaca - アカガシラカシャラカ
Rufous-vented Chachalaca - アカバラカシャラカ
Rusty-Margined Guan - サビフチカンムリケン
Slaty-breasted Tinamou - ウスイロムネチナム
Small-billed Tinamou - コハシチナム
Solitary Tinamou - ヒトリチナム
Speckled Chachalaca - ブチカシャラカ
Spixs Guan - スピックスカンムリケン
Spotted Nothura - ゴマフノトゥラ
Tataupa Tinamou - タタウパチナム
Tawny-breasted Tinamou - アカムネチナム
Thicket Tinamou - ヤブチナム
Undulated Tinamou - ウネウネチナム
Variegated Tinamou - モザイクチナム
West Mexican Chachalaca - ニシメキシコカシャラカ
White-bellied Nothura - シロハラノトゥラ
White-throated Tinamou - シロノドチナム
Yellow-legged Tinamou - キアシチナム